"a" = (/turf/closed/indestructible/rock,/area/awaymission/beach)
"b" = (/turf/closed/mineral/random/high_chance,/area/awaymission/beach)
"c" = (/turf/open/floor/plating/asteroid,/area/awaymission/beach)
"d" = (/turf/open/floor/grass,/area/awaymission/beach)
"e" = (/obj/structure/flora/ausbushes/fullgrass,/turf/open/floor/grass,/area/awaymission/beach)
"f" = (/obj/structure/flora/tree/jungle,/turf/open/floor/grass,/area/awaymission/beach)
"g" = (/obj/structure/flora/ausbushes/lavendergrass,/turf/open/floor/grass,/area/awaymission/beach)
"h" = (/obj/structure/flora/ausbushes/pointybush,/turf/open/floor/grass,/area/awaymission/beach)
"i" = (/obj/structure/flora/ausbushes/ppflowers,/turf/open/floor/grass,/area/awaymission/beach)
"j" = (/turf/open/floor/plating/beach/sand,/area/awaymission/beach)
"k" = (/obj/structure/flora/ausbushes/sparsegrass,/turf/open/floor/grass,/area/awaymission/beach)
"l" = (/obj/structure/flora/ausbushes/reedbush,/turf/open/floor/grass,/area/awaymission/beach)
"m" = (/obj/structure/flora/ausbushes/ywflowers,/turf/open/floor/grass,/area/awaymission/beach)
"n" = (/obj/structure/flora/ausbushes/grassybush,/turf/open/floor/grass,/area/awaymission/beach)
"o" = (/obj/structure/flora/junglebush,/turf/open/floor/grass,/area/awaymission/beach)
"p" = (/turf/open/water{waterd = 16},/area/awaymission/beach)
"q" = (/obj/structure/flora/ausbushes/fernybush,/turf/open/floor/grass,/area/awaymission/beach)
"r" = (/obj/structure/flora/ausbushes/palebush,/turf/open/floor/grass,/area/awaymission/beach)
"s" = (/obj/structure/flora/ausbushes/sunnybush,/turf/open/floor/grass,/area/awaymission/beach)
"t" = (/obj/structure/flora/tree/jungle,/turf/open/floor/plating/beach/sand,/area/awaymission/beach)
"u" = (/turf/open/indestructible,/area/awaymission/beach)
"v" = (/turf/open/indestructible/tel1,/area/awaymission/beach)

(1,1,1) = {"
aaaaaaaaaaaaaaaaaaaaaaaaaaaaaaaaaaaaaaaaaaaaaaaaaaaaaaaaaaaaaaaaaaaaaaaaaaaaaaaaaaaaaaaaaaaaaaaaaaaaaaaaaaaaaaaa
abbbbbbbbbbbbbbbbbbbbbbbbbbbbbbbbbbbbbbbbbbbbbbbbbbbbbbbbbbbbbbbbbbbbbbbbbbbbbbbbbbbbbbbbbbbbbbbbbbbbbbbbbbbbbba
abbbbbbbbbbbbbbbbbcccccbbbbbbcbbbbbbbbbbbbbbbbbbbbbbbbbbbbbbbbbbbbbbbbbbbbbbbbbbbbbbbbbbbbbbbbbbbbbbbbbbbbbbbbba
abbbbbbbbbbbbbdddbcbbbcccbbbbcccbbbbbbbbbbbccbbbbbddddddddddddbbbbbbbbbbbbbbbbbbbbbbbbbbbbbbbbbbcbbbbbbbbbbbbbba
abbbbbbbbbbbbdddddddbbbbccccccccbbbbbbbbbbbccbbbbdddddddddddddddbbbbbbbbbbbbbbbbbbbbbbbbbbbbbbbccccccbbbbbbbbbba
abbbbbbbbbbddddddddddddbbbbbbccccbbbbbbbbbbccbbbbdddddddddddddddddddddbbbbbbbbbbbbbbbbbbbbbbbbcccccccbbbbbbbbbba
abbbbbbbbdddddddddddddddbbbbbbbcccbbbbbbbbcccbbbddddddddddddddddddddddddddbbbbbbbbbbbbbbbbbbbbcccccccccbbbbbbbba
abbbbbbbddddddddddddddddddbbbbbccccbbbbbbcccbbbbdddddddddddddddddddddddddddddbbbbbbbbbbbbbbbbbbcccccccccbbbbbbba
abbbbbbddddddddddddddddddddbbbbbccccbbcccccbbbbdddddddddddddddddeddddddddddddddbbbbbbbbbbbbbbbbbcccccccccbbbbbba
abbbbbbdddddddddddddddddddddbbbbbccccbccccbbbbbddddddddddfddddddddddddddddddddddbbbbbbbbbbbbbbbbbcccccccccbbbbba
abbbbbddddddddddddddddddddddddbbbbbccccccbbbbbbdddddddddddddddgddddddddddddddddddddbbbbbbbbbbbbbbbccccccccbbbbba
abbbbddddddddddddfdddfdddddddddbbbbbcccccbbbbbdddddddddddddhdddddddddddddidddddddddddbbbbbbbbbbbbbbccccccccbbbba
abbbbbddddddddddddddddddddddddddbbbbbbcccbbbbbdddddddfddddddddddddddddddddddddddddddddbbbbbbbbbbbbbbccccccccbbba
abbbbbbddddddddddddddddddddddddddbbbbccccbbbbddddddddddddddddddddddddfddddddddddddedddddbbccccccccccccccccccbbba
abbbbbbddddddddddddddddddddddddddbbbbccbbbbbbdddgdddddddddhddddddddddddddddddddddddddddddbcbbbbbbbbbbcccccccbbba
abbbbbbdddddfdddddddddddddddddddbbbbcccbbbbbdddddddddddddddddddddddddddddddddddddddddddddddbbbbbbbbbbbcccccbbbba
abbbbbbdddddddddddddddddfdddddddbbbbccbbbbbbddddddddddddddddddfdddddddddddddddddddddddddddddbbbbbbbbbbbcccbbbbba
abbbbbbbdddddddddfdddddddddddddbbbbcccbbbbbdddddddddddgddddddddddddddddddddddddddddddddddddddbbbbbbbbbbbbbbbbbba
abbbbbbbbdddddddddddddddddddddbbbbbccbbbbbbddddddddddddddddddddddddddddddddddddddddddddddddddddbbbbbbbbbbbbbbbba
abbbbbbbbdddddddddddddddddddddbbbbcccbbbbbddhdddddddddddddddddddddddddedddddddfdddddddddddddddddbbbbbbbbbbbbbbba
abbbbbbbbbddddddddddddddddddddbbbbccbbbbbddddddddfddddddddfddddddddddddddddddddddddddddddddddddddbbbbbbbbbbbbbba
abbbbbbbbbbdddfddddddddddddddbbbbcccbbbbbedddddddddddedddddddddddddddddddddddddddddddddddddddddddddbbbbbbbbbbbba
abbdbbbbbbbbdddddddddddddddddbbbbccbbbbbdddddddddddddddddddddddddfddddddddddddddddddddddddddddddddddbbbbbbbbbbba
abbddbbbbbbbddddddddfdddddddbbbbcccbbbbbddddddddddddddddddddddddddddddddddddddddddddddfdddddddddddddbbbbbbbbbbba
abddddbbbbbbdddddddddddddddbbbbbccbbbbbdddddddddddddddddddddddddddddddeddddidddddidddddddddddddddddddbbbbbbbbbba
abjddddbbbbbbdddddddddddddbbbbbcccbbbbbdddkdddddddddddddddddldddddddddddmdddddddddddddddddeddddddddddbbbbbbbbbba
abjdddbbbbbbbddddddddddddbbbbbbccbbbbbddddddddddfddddddddddddddddddddddddddddddddddddddddddddddddddddbbbbbbbbbba
abjdddbbbbbbbbdddddddddddbbbbbcccbbbbdddddddddddddddddddddddddddddddddddddddddddddddddddddddddddddddddbbbbbbbbba
abjjdddbbbbbbbddddddddddbbbbbbccbbbbbddddddddnddddddddfddddddeddddddddddddddddfddddddddddiddddodddddddbbbbbbbbba
abjjddddbbbbbbbdddddddddbbbbbcccbbbbbddddddddddddddddddddddddddddddddddddddddddddddddddddddddddddddddddbbbbbbbba
abjjjdddbbbbbbbddddddddbbbbbbccbbbbbbddddddddddldddddddddddddddddddddddddddddddddddddddddddddddddddddddbbbbbbbba
abjjjjdddbbbbbbddddddddbbbbbbccbbbbbbdddddddddddddnddddddddddddddddddfdddddddeddddddddddddddddddddddddddbbbbbbba
abjjjjjdddbbbbbbdddddddbbbbbbcccbbbbbbdddfdddddddddddddddddddddddddddddddddddddddddddfdddddddddddddddddddbbbbbba
abjjjjjddddbbbbbdddddddbbbbbbcccbbbbbbdddddddddddddddddddddmddddddddddddddddddddddddddddddddddddddddddddddbbbbba
abpjjjjjdddbbbbbdddddddccbbbbcccbbbbbbbdddddddeddddddddddddddddddddddeddddddodddddddddddddddddiddddddddddddbbbba
abpjjjjjddddbbbbbdfdddbcccccbcccbbbbbbbddddddddddddddddddddddddddddddddddddddddddddddddddddddddddddddddddddbbbba
abpjjjjjjdddbbbbbdddddbbbbbcccccbbbbbbbbdddddddddddddldddddddddddddddddddddddddddddddmddddddddddddddddddddddbbba
abppjjjjjddddbbbbdddddbbbbbbbccccbbbbbbbbddkdddddddddddddfdddddfddddddddddddddddddddddddddddddddddddddddddddbbba
abppjjjjjjddddbbbddddbbbbbbbbccccbbbbbbbbdddddddddfdddddddddddddddddddddddddddddddddddddddddeddddddddddddddddbba
abpppjjjjjdddddddddddbbbbbbbbccccbbbbbbbbbdddddddddddddddddddddddddddddmdddddddddddddddddddddddddfdddddddddddbba
abpppjjjjjdddqddddddbbbbbbbbbbccccbbbbbbbbcdddddddddddddddddddddddddddddddddddfddddddddddddddddddddddddddddddbba
abpppjjjjjddddddddddbbbbbbbbbbccccbbbbbbccccdddddddkdddddddddddeddddddddddddddddddddoddddddddddddddddddddddddbba
abppppjjjjddddeddddbbbbbbbbbbbcccccbbbcccccbbbddddddddddddddoddddddddddddddddddddddddddddedddddddddddddddddddbba
abppppjjjjdddddddddbbbbbbbbbbbbccccbbccccbbbbbbddddddddddddddddddddddfdddddddddddddddddddddddddddddddddddkdddbba
abppppjjjjddddddddbbbbbbbbbbbbbccccccccbbbbbbbbbddoddddddddddddddddddddddddddddddddddddddddddddddddddddddddddbba
abppppjjjjfddddddbbbbbbbbbbbbbbcccccccbbbbccbbbbbbbbbbbddddddddddddddddddddddddkdddddddddddddddddddddkdddddddbba
abpppppjjjddddddbbbbbbbbbbbbbcccccccccbbbccccccbbbbbbbbbbbddddddddddddddddddddddddddddddddddfddddddddddddddddbba
abpppppjjjdeddddbbbbbbbbbbcccccccccccccbbbccccccbbbbbbbbbbbbbbdddddddddddddddddddddddddddddddddddddddddddddddbba
abpppppjjjjdddddbbbbbbbbbcccccccccccccccbbbcccccccbbbbbbbbbbbbbbbddddddddddddddddddddddddddddddddddddddddddddbba
abppppppjjjddddddbbbbbbbbcccccccbbbbcccccbbbbccccbbbcccccbbbbbbbbbbddddkdddddddddkddddddddddddddjjjjjjjjjjjjjbba
abpppppppjjjdddddbbbbbbbbcccccbbbbbbccccccbbbbcccbbcccccccccbbbbbbbdddddddddddddddddddddddddjjjjjjjjjjjjjjjjjbba
abpppppppjjjddqddbbbbbbbbcccbbbbcbbbbcccccccbbbccccccccccccccbbbbbbddddddddddddddddddjjjjjjjjjjjjjjjjjjjjjjjjbba
abppppppppjjjdddddbbbbbbbbbbbbbcccbbbbcccccccbbbbbccccccccccccbbbbbddddddddddddddddjjjjjjjjjjjjjjjjjjjjjjjjjjbba
abppppppppjjjddddddbbbbbbbbbbbcccccbbbbccccccbbbbbbbccccccccccbbbbbdddddddddddddddjjjjjjjjjjjjjjjjpppppppppppbba
abbpppppppjjjjdddddbbbbbbbbbccccccccbbbbbccccbbbbbbbbccccccccbbbbbbddddddddddddjjjjjjjjjjjjjppppppppppppppppbbba
abbpppppppjjjjddddddbbbbbbbcccccccccccbbbbbcccccccbbccbcbbcbbbbbbbbddddddddddjjjjjjjjjjjpppppppppppppppppppjbbba
abbppppppppjjjjddeddddbbbbbccccccccccccbbbbbcccccccccbbbbbbbbbbbbbdddddddddjjjjjjjjjjpppppppppppjjjjjjjjjjjjbbba
abbppppppppjjjjjdddddddbbbbbccccccccccccbbcccccccccccbbbbbbbbbbbdddddodddddjjjjjjjjppppppppppjjjjjjjjjjjjjjdbbba
abbppppppppjjjjjjdddddddbbbbbbbcccccccccbbccccccccccccbbbbbbbbbdddddddddddjjjjjjjjppppppppjjjjjjjjjjjjjjjdddbbba
abbpppppppppjjjjjdddqdddddbbbbbbbcccccccbbccccccccccbbbbbbbbbdddddddddddjjjjjjjjjppppppjjjjjjjjjjdddddddddddbbba
abbpppppppppjjjjjjddddddddddbbbbbbbbcccccccccccccccbbbbbbbbbdddddddddddjjjjjjpppppppppjjjjjjjddddddddddrddddbbba
abbpppppppppjjjjjjjdddddddddddbbbbbbbbbbbbbbbbbbbbbbbbbbbbdddddddddddjjjjjjjppppppppjjjjjjdddddddddddddddddddbba
abbppppppppppjjjjjjjddedoddddddddbbbbbbbbbbbbbbbbbbbbbdddddmddddddddjjjjjjjppppppppjjjjjdddddmdgdddddddgdddddbba
abbppppppppppjjjjjjjjdddddddqddddddddbbbbbbbbbbbbbbddddddddddddddjjjjjjjjjppppppppjjjdddddddddddddddddrdddgddbba
abbppppppppppjjjjjjjjjjdddddddddddddqdddddddbbbbddddddddddddddddjjjjjjjjjppppppppjjjdddddddsddddrddddddddddddbba
abbbppppppppppjjjjjjjjjjdddkddddodddddddkdddddddddddddkddddddddjjjjjjjjjppppppppjjjddddmddddddddddjjjjjjjjjjjbba
abbbpppppppppppjjjjjjjjjjddddddddddddddddddddddddiddddddddddddjjjjjjjjjppppppppjjjdddddddddddjjjjjjjjjjjjjjjbbba
abbbpppppppppppppppjjjjjjjjddddddddddddddddddddoddddddddddddddjjjjjjjppppppppppjjjddsdddddjjjjjjjjjjjjjjjjjjbbba
abbbppppppppppppppppjjjjjjjjjdddddddddddqddddddddddddddddddkdjjjjjjjpppppppppppjjjjdddddjjjjjjjjjjjjppppppppbbba
abbbpppppppppppppppppjjjjjjjjjjjdkddddjjjjjjjjjddddddddddddddjjjjjjppppppppppppjjjjjjjjjjjjjjjjjjpppppppppppbbba
abbbppppppppppppppppppjjjjjjjjjjjjjjjjjjjjjjjjjjjjjdddddddjjjjjjjjppppppppppppppjjjjjjjjjjppppppppppppppppppbbba
abbpppppppppjpppppppppppjjjjjjjjjjjjjjjjjjjjjjjjjjjjjjjjjjjjjjjjjppppppppppppppppppppppppppppppppppppppjjjjjbbba
abbppppppppjjjjppppppppppppppjjjjjjjjjjjjjjjjjjjjjjjjjjjjjjjjjjjppppppppppppppppppppppppppppppppjjjjjjjjjjjjbbba
abbpppppppjjjjjjjpppppppppppppjjjjjjjjjjjpppjjjjjjjjjjjjjjjjjpppppppppppppppppppppppppppppppppjjjjjjjjjjjjjjjbba
abbppppppjjjjjjjjjpppppppppppppppppjjjjpppppppppjjjjjjjjjjppppppppppppppppppppppppppppppppjjjjjjjjjjjjjjjjjjjbba
abbpppppjjjdddjjjjjppppppppppppppppppppppppppppppppppppppppppppppppppppppppppppppppppppjjjjjjjjjjjjjjjjjjjdddbba
abbppppjjjdddddjjjjjpppppppppppppppppppppppppppppppppppppppppppppppppppppppppppppppppjjjjjjjjjjjjjjddddddddddbba
abbppppjjddddddjjjjjjjpppppppppppppppppppppppppppppppppppppppppppppppppppppppppppppjjjjjjjjjjjddddddddddgddddbba
abbppjjjdfddddddjjjjjjjjjppppppppppppppppppppppppppppppppppppppppppppppppppppppppjjjjjjjjjjjddddddgddddddddddbba
abbpjjjjddddbddddjjjjjjjjjjjppppppppppppppppppppppjpppppppppppppppppppppppppppppjjjjjjjjjdddmddddddddddddddddbba
abbpjjjjdddbbbbddddjjjjjjjjjjjjppppppppppppppppppjjjjppppppppppppppppppppppppjjjjjjjjjjdddddddddddddgddddmdddbba
abbpjjjjddbbbbbddfdddjjjjjtjjjjjjjjjpppppppppppjjjjjjpppppppppppppppppppppjjjjjjjjjddddddddddddddddddddddddddbba
abbpjjjdddbbbbbbdddddddddjjjjjjjjjjjjjjjjjjjjjjjjjjjjppppppppppppppppppjjjjjjjjdddddddddddddqddddsddddddbbbbbbba
abppjjjddddbbbbbbddddddddfdfddfddjjjjjjjjjjjjjjjjjjjppppppppppppppppjjjjjjjjddddddddddddmddddddddddddbbbbbbbbbba
abppjjjjfddbbbbbbbbdddfdfddddfddddddddjjjjjjdjjjjjjjppppppppppppppjjjjjjjjdddddddsdddgddddddddddddbbbbbbbbbbbbba
abppjjjjdddbbbbbbbbbbfddddddddfdddddfddddddddddjjjjppppppppppppjjjjjjjjjjdddddddddddddddddddddddbbbbbbbbbbbbbbba
abppjjjjjdddbbbbbbbbbbbddddddbbbbddddddddddddddjjjjpppppppppppjjjjjjjjjjdddddddddqdddddddddbbbbbbbbbbbbbbbbbbbba
abpppjjjjjdfdbbbbccccbbbbcbbbbbbbbbbbbdddfdddddjjjppppppppppjjjjjjjjjjjdddddedddddddddsdddbbbbbbbbbbbbbbbbbbbbba
abpppjjjjjjdddbbbccccbbbcccbcccccccbbbbbddddddjjjpppppppppjjjjjjjjjjjjdddddddddddddeddddddbbbbbbbbbbbbbbbbbbbbba
abppppjjjjjddddbbccccccbcccbcccccccbbbbbdddddjjjpppppppppjjjjjjjjjjdddddddddddddddddddddddbbbbbbbbbbbbbbbbbbbbba
abpppppjjjjjddddbccccccbcccccccccccbbbbbddddjjjjppppppppjjjjjjjjjjddddddddeedddddddddddddddbbbbbbbbbbbbbbbbbbbba
abpppppjjjjfdddbbccccccccccbcccccccbbbdddddjjjjpppppppppjjjjjjjjdddddddddddddddddedddddddddddbbbbbbbbbbbbbbbbbba
abpppppjjjjdddddbccccccbcccbcccccbbbddddddjjjjpppppppppjjjjjjjdddddddddddddddddddddddsdddddddddbbbbbbbbbbbbbbbba
abbpppjjjjjdddddbccccccbbcbbcccccbbddddddjjjjjpppppppppjjjjjddddddddddddddddddddddddddddddddddddbbbbbbbbbbbbbbba
abbpppjjjjjddddbbccccccbcccbbbbbbbdddfdddjjjjpppppppppjjjjjddddddddddddddddddddbbbbbddddddddddddddbbbbbbbbbbbbba
abbpppjjjjjfddddbbbbbbbbcccbbbbdddddddddjjjjppppppppppjjjjddddddddddddddddedddbbbbbbbbbdddddddddddddbbbbbbbbbcba
abbpppjjjjjddddddddbbbuuuccbbddddddddddjjjjppppppppppjjjjdddddddddddddddddddbbbbbbbbbbbbbddddddddddddbbbbbbcccba
abbpppjjjjjdddddddddbbvuuuubbdddddddddjjjjjppppppppppjjjdddddddddddddddddddbbbbbbbbbbbbbbbdddddddddddccbbbccccba
abppppjjjjjjdddddddddbuuuubbddddfdddjjjjjppppppppppppjjjddddddddddddddddddbbbbbbbbbbbbbbbbbbddddddddccccccccccba
abpppppjjjjjdddfdddddbbbbbbddddddddjjjjjppppppppppppjjjjddddddddfddddddddbbbbbbbbbbbbbbbbbbbbbddddddccccccccccba
abppppppjjjjddddddddddbbbbdddddddjjjjjjppppppppppppjjjjdddddddddddddddddbbbbbbbbbbbbbbbbbbbbbbbbdddccccccccccbba
abpppppppjjjjdddddddddddddddddddjjjjjjppppppppppppjjjjdddddddddddddddddbbbbbbbbbbbbbbbbbbbbbbbbbdddccccccccccbba
abbpppppppjjjjjjjjdddddddddddddjjjjjjppppppppppppjjjjdddddddddddddddddbbbbbbbbbbbbbbbbbbbbbbbbbbbdcccccccccccbba
abbppppppppjjjjjjjjjdddfddddddjjjjjjppppppppppppjjjjjddddddddddddddddbbbbbbbbbbbbbbbbbbbbbbbbbbbbbcccccccccccbba
abbpppppppppjjjjjjjjjjjjddddddjjjjjpppppppppppppjjjjddddddddddddddddbbbbbbbbbbbbbbbbbbbbbbbbbbbbbbbccccccccccbba
abbppppppppppjjjjjjjjjjjjjjjjjjjjjpppppppppppppjjjjjdddddddddddddddbbbbbbbbbbbbbbbbbbbbbbbbbbbbbbbccccccccccbbba
abbbppppppppppjjjjppjjjjjjjjjjjjjpppppppppppppjjjjjdddddddddddddddbbbbbbbbbbbbbbbbbbbbbbbbbbbbbbbcccccccccccbbba
abbbpppppppppppppppppppjjjjjjjjppppppppppppppjjjjjddddddddddfddddbbbbbbbbbbbbbbbbbbbbbbbbbbbbbbbcccccccccccbbbba
abbbbpppppppppppppppppppppppppppppppppppppppjjjjjjddddfdddddddddbbbbbbbbbbbbbbbbbbbbbbbbbbbbbbbbccccccccbbbbbbba
abbbbbbbbppppppppppppppppppppppppppppppppppjjjjjjddddddddddddddbbbbbbbbbbbbbbbbbbbbbbbbbbbbbbbbbbbbbbbbbbbbbbbba
abbbbbbbbbbbbbbbbbbbbbbbbbbbbbbbbbbbbbbbbbbbbbbbbbbbbbbbbbbbbbbbbbbbbbbbbbbbbbbbbbbbbbbbbbbbbbbbbbbbbbbbbbbbbbba
aaaaaaaaaaaaaaaaaaaaaaaaaaaaaaaaaaaaaaaaaaaaaaaaaaaaaaaaaaaaaaaaaaaaaaaaaaaaaaaaaaaaaaaaaaaaaaaaaaaaaaaaaaaaaaaa
"}
